 ##### 
 #   # 
 # $ # 
 # # # 
## $ ##
#  #  #
# *#* #
# $+  #
# *#* #
#  *  #
##   ##
 # # # 
 #. .# 
 ##### 