######       
#    #       
#$#  #       
# #  #       
# #.#######  
#.# # #   #  
###$### # ###
#@$         #
######### # #
        #   #
        #####