#####
# @ #
# $ #
# . #
#.$.#
##.##
# $ #
#   #
#   #
# $ #
#   #
#####