##########
#        #
# # # # ##
#  $ $ $ #
#.## # # #
#.#     @#
#.########
###       